......#........................
......#........................
......#........................
...................####........
...............................
...#########...................
.......................#####...
.......................#...#...
.......................#####...
...............................